date,sick,resolved,fatal,count,days,utc
2020-01-23,0,2,0,2,0,43853
2020-01-24,0,1,0,1,1,43854
2020-02-21,0,1,0,1,2,43882
2020-02-25,0,1,0,1,3,43886
2020-02-26,0,1,0,1,4,43887
2020-02-27,0,2,0,2,5,43888
2020-02-28,0,5,0,5,6,43889
2020-02-29,0,4,0,4,7,43890
2020-03-01,0,2,0,2,8,43891
2020-03-03,0,2,0,2,9,43893
2020-03-04,0,1,0,1,10,43894
2020-03-05,0,4,0,4,11,43895
2020-03-06,0,2,0,2,12,43896
2020-03-07,0,3,0,3,13,43897
2020-03-08,0,4,1,5,14,43898
2020-03-09,0,5,0,5,15,43899
2020-03-10,0,9,0,9,16,43900
2020-03-11,0,24,0,24,17,43901
2020-03-12,0,36,1,37,18,43902
2020-03-13,0,34,2,36,19,43903
2020-03-14,0,31,0,31,20,43904
2020-03-15,0,36,0,36,21,43905
2020-03-16,0,52,1,53,22,43906
2020-03-17,0,56,2,58,23,43907
2020-03-18,0,55,2,57,24,43908
2020-03-19,0,63,2,65,25,43909
2020-03-20,0,93,4,97,26,43910
2020-03-21,0,62,9,71,27,43911
2020-03-22,0,80,5,85,28,43912
2020-03-23,0,134,9,143,29,43913
2020-03-24,1,164,7,172,30,43914
2020-03-25,0,125,11,136,31,43915
2020-03-26,0,234,13,247,32,43916
2020-03-27,0,272,19,291,33,43917
2020-03-28,0,216,19,235,34,43918
2020-03-29,0,201,26,227,35,43919
2020-03-30,0,414,22,436,36,43920
2020-03-31,0,376,34,410,37,43921
2020-04-01,0,417,31,448,38,43922
2020-04-02,0,394,54,448,39,43923
2020-04-03,0,383,80,463,40,43924
2020-04-04,0,308,40,348,41,43925
2020-04-05,0,327,44,371,42,43926
2020-04-06,0,392,81,473,43,43927
2020-04-07,0,385,72,457,44,43928
2020-04-08,0,423,65,488,45,43929
2020-04-09,0,425,54,479,46,43930
2020-04-10,0,334,62,396,47,43931
2020-04-11,0,403,67,470,48,43932
2020-04-12,0,450,88,538,49,43933
2020-04-13,0,511,81,592,50,43934
2020-04-14,0,472,80,552,51,43935
2020-04-15,0,519,94,613,52,43936
2020-04-16,0,481,91,572,53,43937
2020-04-17,0,617,123,740,54,43938
2020-04-18,0,516,85,601,55,43939
2020-04-19,0,527,63,590,56,43940
2020-04-20,0,557,52,609,57,43941
2020-04-21,0,455,63,518,58,43942
2020-04-22,0,477,69,546,59,43943
2020-04-23,0,438,70,508,60,43944
2020-04-24,0,389,44,433,61,43945
2020-04-25,0,369,56,425,62,43946
2020-04-26,0,326,41,367,63,43947
2020-04-27,0,430,49,479,64,43948
2020-04-28,0,368,44,412,65,43949
2020-04-29,0,361,46,407,66,43950
2020-04-30,0,363,41,404,67,43951
2020-05-01,0,444,44,488,68,43952
2020-05-02,0,304,28,332,69,43953
2020-05-03,0,314,25,339,70,43954
2020-05-04,0,311,21,332,71,43955
2020-05-05,0,381,28,409,72,43956
2020-05-06,0,321,34,355,73,43957
2020-05-07,0,284,20,304,74,43958
2020-05-08,0,272,23,295,75,43959
2020-05-09,0,284,26,310,76,43960
2020-05-10,0,256,36,292,77,43961
2020-05-11,0,198,17,215,78,43962
2020-05-12,0,221,27,248,79,43963
2020-05-13,0,326,25,351,80,43964
2020-05-14,0,312,29,341,81,43965
2020-05-15,0,352,28,380,82,43966
2020-05-16,0,346,19,365,83,43967
2020-05-17,0,395,23,418,84,43968
2020-05-18,0,354,24,378,85,43969
2020-05-19,0,309,17,326,86,43970
2020-05-20,0,366,21,387,87,43971
2020-05-21,0,324,14,338,88,43972
2020-05-22,0,379,22,401,89,43973
2020-05-23,0,348,19,367,90,43974
2020-05-24,0,330,11,341,91,43975
2020-05-25,0,383,15,398,92,43976
2020-05-26,0,263,10,273,93,43977
2020-05-27,0,318,6,324,94,43978
2020-05-28,0,313,12,325,95,43979
2020-05-29,0,579,16,595,96,43980
2020-05-30,0,335,11,346,97,43981
2020-05-31,0,403,11,414,98,43982
2020-06-01,0,389,9,398,99,43983
2020-06-02,0,362,3,365,100,43984
2020-06-03,0,338,9,347,101,43985
2020-06-04,0,273,6,279,102,43986
2020-06-05,0,274,4,278,103,43987
2020-06-06,0,215,7,222,104,43988
2020-06-07,0,206,1,207,105,43989
2020-06-08,0,209,6,215,106,43990
2020-06-09,0,211,5,216,107,43991
2020-06-10,0,231,6,237,108,43992
2020-06-11,0,180,7,187,109,43993
2020-06-12,0,237,2,239,110,43994
2020-06-13,0,168,3,171,111,43995
2020-06-14,0,144,0,144,112,43996
2020-06-15,0,175,2,177,113,43997
2020-06-16,0,172,4,176,114,43998
2020-06-17,0,189,3,192,115,43999
2020-06-18,0,192,6,198,116,44000
2020-06-19,0,186,3,189,117,44001
2020-06-20,0,153,2,155,118,44002
2020-06-21,0,169,6,175,119,44003
2020-06-22,0,201,2,203,120,44004
2020-06-23,0,149,2,151,121,44005
2020-06-24,0,162,2,164,122,44006
2020-06-25,0,144,2,146,123,44007
2020-06-26,0,177,5,182,124,44008
2020-06-27,0,229,2,231,125,44009
2020-06-28,0,200,5,205,126,44010
2020-06-29,0,128,2,130,127,44011
2020-06-30,0,176,1,177,128,44012
2020-07-01,0,149,2,151,129,44013
2020-07-02,0,137,4,141,130,44014
2020-07-03,0,152,0,152,131,44015
2020-07-04,0,125,2,127,132,44016
2020-07-05,0,92,0,92,133,44017
2020-07-06,0,105,0,105,134,44018
2020-07-07,0,133,6,139,135,44019
2020-07-08,0,140,3,143,136,44020
2020-07-09,0,134,3,137,137,44021
2020-07-10,0,122,2,124,138,44022
2020-07-11,0,127,1,128,139,44023
2020-07-12,0,112,1,113,140,44024
2020-07-13,0,98,0,98,141,44025
2020-07-14,0,103,2,105,142,44026
2020-07-15,0,133,0,133,143,44027
2020-07-16,0,137,5,142,144,44028
2020-07-17,0,165,0,165,145,44029
2020-07-18,0,174,0,174,146,44030
2020-07-19,0,120,1,121,147,44031
2020-07-20,0,175,2,177,148,44032
2020-07-21,0,118,0,118,149,44033
2020-07-22,0,120,2,122,150,44034
2020-07-23,0,194,0,194,151,44035
2020-07-24,0,139,0,139,152,44036
2020-07-25,0,118,0,118,153,44037
2020-07-26,0,124,1,125,154,44038
2020-07-27,0,120,1,121,155,44039
2020-07-28,0,122,0,122,156,44040
2020-07-29,0,98,1,99,157,44041
2020-07-30,0,108,1,109,158,44042
2020-07-31,0,125,1,126,159,44043
2020-08-01,0,102,0,102,160,44044
2020-08-02,0,56,1,57,161,44045
2020-08-03,0,98,0,98,162,44046
2020-08-04,0,88,0,88,163,44047
2020-08-05,0,81,0,81,164,44048
2020-08-06,0,96,0,96,165,44049
2020-08-07,0,81,0,81,166,44050
2020-08-08,0,92,0,92,167,44051
2020-08-09,0,89,1,90,168,44052
2020-08-10,0,69,0,69,169,44053
2020-08-11,0,88,0,88,170,44054
2020-08-12,0,96,0,96,171,44055
2020-08-13,0,90,1,91,172,44056
2020-08-14,0,90,1,91,173,44057
2020-08-15,0,86,0,86,174,44058
2020-08-16,0,100,0,100,175,44059
2020-08-17,0,98,1,99,176,44060
2020-08-18,0,104,0,104,177,44061
2020-08-19,0,103,1,104,178,44062
2020-08-20,0,106,2,108,179,44063
2020-08-21,0,133,0,133,180,44064
2020-08-22,0,82,0,82,181,44065
2020-08-23,0,98,3,101,182,44066
2020-08-24,0,117,1,118,183,44067
2020-08-25,0,119,1,120,184,44068
2020-08-26,0,131,1,132,185,44069
2020-08-27,0,150,0,150,186,44070
2020-08-28,0,121,0,121,187,44071
2020-08-29,0,111,0,111,188,44072
2020-08-30,0,121,0,121,189,44073
2020-08-31,0,136,0,136,190,44074
2020-09-01,0,123,0,123,191,44075
2020-09-02,0,123,4,127,192,44076
2020-09-03,0,169,0,169,193,44077
2020-09-04,0,153,2,155,194,44078
2020-09-05,0,146,2,148,195,44079
2020-09-06,0,188,5,193,196,44080
2020-09-07,0,170,2,172,197,44081
2020-09-08,0,181,0,181,198,44082
2020-09-09,0,193,0,193,199,44083
2020-09-10,0,202,0,202,200,44084
2020-09-11,0,263,2,265,201,44085
2020-09-12,0,296,1,297,202,44086
2020-09-13,0,213,0,213,203,44087
2020-09-14,0,278,2,280,204,44088
2020-09-15,0,314,3,317,205,44089
2020-09-16,0,333,2,335,206,44090
2020-09-17,0,430,0,430,207,44091
2020-09-18,0,393,4,397,208,44092
2020-09-19,0,396,4,400,209,44093
2020-09-20,0,399,1,400,210,44094
2020-09-21,0,385,3,388,211,44095
2020-09-22,0,365,5,370,212,44096
2020-09-23,0,392,4,396,213,44097
2020-09-24,0,424,5,429,214,44098
2020-09-25,0,509,6,515,215,44099
2020-09-26,0,620,6,626,216,44100
2020-09-27,0,556,5,561,217,44101
2020-09-28,0,530,3,533,218,44102
2020-09-29,0,599,8,607,219,44103
2020-09-30,0,674,10,684,220,44104
2020-10-01,0,612,10,622,221,44105
2020-10-02,0,671,4,675,222,44106
2020-10-03,1,536,6,543,223,44107
2020-10-04,0,581,5,586,224,44108
2020-10-05,0,573,6,579,225,44109
2020-10-06,0,752,7,759,226,44110
2020-10-07,0,868,12,880,227,44111
2020-10-08,0,737,8,745,228,44112
2020-10-09,0,785,15,800,229,44113
2020-10-10,1,685,2,688,230,44114
2020-10-11,0,786,11,797,231,44115
2020-10-12,0,590,3,593,232,44116
2020-10-13,0,825,10,835,233,44117
2020-10-14,0,870,10,880,234,44118
2020-10-15,0,756,8,764,235,44119
2020-10-16,0,694,12,706,236,44120
2020-10-17,0,695,11,706,237,44121
2020-10-18,0,797,6,803,238,44122
2020-10-19,0,739,14,753,239,44123
2020-10-20,0,750,10,760,240,44124
2020-10-21,0,829,13,842,241,44125
2020-10-22,0,967,24,991,242,44126
2020-10-23,0,938,15,953,243,44127
2020-10-24,0,926,13,939,244,44128
2020-10-25,0,871,12,883,245,44129
2020-10-26,0,767,10,777,246,44130
2020-10-27,0,864,11,875,247,44131
2020-10-28,0,909,16,925,248,44132
2020-10-29,0,867,23,890,249,44133
2020-10-30,0,1069,22,1091,250,44134
2020-10-31,0,930,13,943,251,44135
2020-11-01,0,1094,7,1101,252,44136
2020-11-02,0,942,27,969,253,44137
2020-11-03,0,855,22,877,254,44138
2020-11-04,0,930,16,946,255,44139
2020-11-05,0,1239,21,1260,256,44140
2020-11-06,0,1259,37,1296,257,44141
2020-11-07,0,1141,21,1162,258,44142
2020-11-08,0,1311,14,1325,259,44143
2020-11-09,2,1388,37,1427,260,44144
2020-11-10,1,1544,29,1574,261,44145
2020-11-11,2,1517,18,1537,262,44146
2020-11-12,1,1581,13,1595,263,44147
2020-11-13,0,1462,21,1483,264,44148
2020-11-14,2,1467,25,1494,265,44149
2020-11-15,0,1284,8,1292,266,44150
2020-11-16,0,1330,10,1340,267,44151
2020-11-17,1,1221,25,1247,268,44152
2020-11-18,0,1445,19,1464,269,44153
2020-11-19,0,1482,16,1498,270,44154
2020-11-20,0,1623,17,1640,271,44155
2020-11-21,0,1485,20,1505,272,44156
2020-11-22,0,1300,19,1319,273,44157
2020-11-23,0,1343,19,1362,274,44158
2020-11-24,0,1389,21,1410,275,44159
2020-11-25,0,1665,22,1687,276,44160
2020-11-26,0,1819,38,1857,277,44161
2020-11-27,1,1732,28,1761,278,44162
2020-11-28,0,1693,35,1728,279,44163
2020-11-29,0,1663,18,1681,280,44164
2020-11-30,0,1577,49,1626,281,44165
2020-12-01,0,1782,34,1816,282,44166
2020-12-02,0,1740,20,1760,283,44167
2020-12-03,0,1800,27,1827,284,44168
2020-12-04,0,1852,39,1891,285,44169
2020-12-05,0,2061,26,2087,286,44170
2020-12-06,0,1704,32,1736,287,44171
2020-12-07,0,1755,23,1778,288,44172
2020-12-08,0,1830,36,1866,289,44173
2020-12-09,1,1876,32,1909,290,44174
2020-12-10,0,1847,36,1883,291,44175
2020-12-11,1,1861,46,1908,292,44176
2020-12-12,0,1923,47,1970,293,44177
2020-12-13,0,1925,51,1976,294,44178
2020-12-14,0,2036,29,2065,295,44179
2020-12-15,1,2181,60,2242,296,44180
2020-12-16,0,2261,45,2306,297,44181
2020-12-17,0,2314,57,2371,298,44182
2020-12-18,0,2348,69,2417,299,44183
2020-12-19,0,2224,46,2270,300,44184
2020-12-20,0,2284,57,2341,301,44185
2020-12-21,0,2124,39,2163,302,44186
2020-12-22,1,2510,46,2557,303,44187
2020-12-23,1,2187,32,2220,304,44188
2020-12-24,0,1881,46,1927,305,44189
2020-12-25,0,2143,44,2187,306,44190
2020-12-26,0,2191,46,2237,307,44191
2020-12-27,0,2088,51,2139,308,44192
2020-12-28,0,2700,35,2735,309,44193
2020-12-29,1,3144,49,3194,310,44194
2020-12-30,0,2764,42,2806,311,44195
2020-12-31,0,3354,58,3412,312,44196
2021-01-01,0,3229,44,3273,313,44197
2021-01-02,0,2832,54,2886,314,44198
2021-01-03,0,3231,71,3302,315,44199
2021-01-04,1,3093,45,3139,316,44200
2021-01-05,2,3260,64,3326,317,44201
2021-01-06,1,3690,53,3744,318,44202
2021-01-07,0,4102,68,4170,319,44203
2021-01-08,2,3774,49,3825,320,44204
2021-01-09,2,3305,66,3373,321,44205
2021-01-10,0,3034,75,3109,322,44206
2021-01-11,1,2771,61,2833,323,44207
2021-01-12,0,3097,70,3167,324,44208
2021-01-13,7,3276,48,3331,325,44209
2021-01-14,1,2945,43,2989,326,44210
2021-01-15,2,3147,60,3209,327,44211
2021-01-16,0,2677,46,2723,328,44212
2021-01-17,0,2050,37,2087,329,44213
2021-01-18,1,2350,49,2400,330,44214
2021-01-19,0,2362,49,2411,331,44215
2021-01-20,3,2701,50,2754,332,44216
2021-01-21,0,2300,48,2348,333,44217
2021-01-22,2,2429,36,2467,334,44218
2021-01-23,2,1883,36,1921,335,44219
2021-01-24,2,1746,34,1782,336,44220
2021-01-25,0,1587,33,1620,337,44221
2021-01-26,0,1865,30,1895,338,44222
2021-01-27,0,1929,27,1956,339,44223
2021-01-28,0,1929,28,1957,340,44224
2021-01-29,0,1838,31,1869,341,44225
2021-01-30,0,1626,17,1643,342,44226
2021-01-31,0,1425,25,1450,343,44227
2021-02-01,0,1246,15,1261,344,44228
2021-02-02,0,1429,15,1444,345,44229
2021-02-03,1,1470,19,1490,346,44230
2021-02-04,0,1358,21,1379,347,44231
2021-02-05,0,1482,14,1496,348,44232
2021-02-06,1,1230,12,1243,349,44233
2021-02-07,2,1081,14,1097,350,44234
2021-02-08,1,943,15,959,351,44235
2021-02-09,0,1114,13,1127,352,44236
2021-02-10,2,1277,22,1301,353,44237
2021-02-11,2,1197,15,1214,354,44238
2021-02-12,0,1170,9,1179,355,44239
2021-02-13,0,981,13,994,356,44240
2021-02-14,0,924,7,931,357,44241
2021-02-15,0,843,14,857,358,44242
2021-02-16,2,989,10,1001,359,44243
2021-02-17,1,1087,11,1099,360,44244
2021-02-18,3,1177,15,1195,361,44245
2021-02-19,1,1202,12,1215,362,44246
2021-02-20,4,1126,12,1142,363,44247
2021-02-21,1,972,7,980,364,44248
2021-02-22,8,884,8,900,365,44249
2021-02-23,2,1110,10,1122,366,44250
2021-02-24,5,1175,12,1192,367,44251
2021-02-25,7,1223,6,1236,368,44252
2021-02-26,4,1097,7,1108,369,44253
2021-02-27,9,1102,3,1114,370,44254
2021-02-28,4,992,5,1001,371,44255
2021-03-01,6,902,7,915,372,44256
2021-03-02,16,1098,8,1122,373,44257
2021-03-03,56,1069,4,1129,374,44258
2021-03-04,241,978,6,1225,375,44259
2021-03-05,352,887,7,1246,376,44260
2021-03-06,480,794,7,1281,377,44261
2021-03-07,531,713,3,1247,378,44262
2021-03-08,719,451,5,1175,379,44263
2021-03-09,855,375,3,1233,380,44264
2021-03-10,1050,276,5,1331,381,44265
2021-03-11,1230,203,2,1435,382,44266
2021-03-12,1446,144,2,1592,383,44267
2021-03-13,1316,69,1,1386,384,44268
2021-03-14,1168,56,1,1225,385,44269
2021-03-15,1167,26,0,1193,386,44270
2021-03-16,1417,16,2,1435,387,44271
2021-03-17,656,6,0,662,388,44272
