age_group,fatal-f,fatal-m,fatal-gd,fatal-u,fatal-total,fatal%
80s,1393,1322,0,18,2733,0.36
90+,1502,761,0,19,2282,0.3
70s,566,896,0,4,1466,0.19
60s,234,451,0,2,687,0.09
50s,93,161,0,1,255,0.03
40s,24,46,0,0,70,0.01
30s,7,15,0,1,23,0.0
20s,3,9,0,0,12,0.0
<20,1,1,0,0,2,0.0
UNKNOWN,0,0,0,1,1,0.0
