age_group,fatal-f,fatal-m,fatal-gd,fatal-u,fatal-total,fatal%
80s,1555,1513,0,20,3088,0.35
90+,1582,820,0,18,2420,0.27
70s,703,1096,0,6,1805,0.2
60s,319,639,0,7,965,0.11
50s,144,268,0,2,414,0.05
40s,39,79,0,1,119,0.01
30s,14,31,0,3,48,0.01
20s,7,15,0,1,23,0.0
<20,2,2,0,0,4,0.0
UNKNOWN,0,0,0,1,1,0.0
