age_group,fatal-f,fatal-m,fatal-gd,fatal-u,fatal-total,fatal%
80s,1357,1288,0,17,2662,0.36
90+,1487,751,0,19,2257,0.31
70s,543,866,0,4,1413,0.19
60s,221,425,0,2,648,0.09
50s,88,156,0,1,245,0.03
40s,22,44,0,0,66,0.01
30s,7,15,0,0,22,0.0
20s,3,8,0,0,11,0.0
<20,1,1,0,0,2,0.0
UNKNOWN,0,0,0,1,1,0.0
