age_group,fatal-f,fatal-m,fatal-gd,fatal-u,fatal-total,fatal%
80s,1471,1415,0,19,2905,0.36
90+,1526,783,0,19,2328,0.29
70s,628,971,0,6,1605,0.2
60s,269,505,0,5,779,0.1
50s,105,190,0,3,298,0.04
40s,27,52,0,0,79,0.01
30s,10,23,0,3,36,0.0
20s,5,10,0,1,16,0.0
<20,2,1,0,0,3,0.0
UNKNOWN,0,0,0,1,1,0.0
