age_group,fatal-f,fatal-m,fatal-gd,fatal-u,fatal-total,fatal%
80s,1483,1425,0,20,2928,0.36
90+,1536,789,0,20,2345,0.29
70s,633,985,0,5,1623,0.2
60s,279,516,0,5,800,0.1
50s,108,196,0,2,306,0.04
40s,28,55,0,0,83,0.01
30s,10,23,0,3,36,0.0
20s,5,12,0,1,18,0.0
<20,2,1,0,0,3,0.0
UNKNOWN,0,0,0,1,1,0.0
