age_group,fatal-f,fatal-m,fatal-gd,fatal-u,fatal-total,fatal%
80s,1352,1284,0,17,2653,0.36
90+,1485,751,0,19,2255,0.31
70s,540,864,0,4,1408,0.19
60s,220,424,0,2,646,0.09
50s,88,156,0,1,245,0.03
40s,22,43,0,0,65,0.01
30s,7,15,0,0,22,0.0
20s,3,8,0,0,11,0.0
<20,1,1,0,0,2,0.0
UNKNOWN,0,0,0,1,1,0.0
